蒙德=Mondstadt
璃月=Liyue
安柏=Amber
凯亚=Kaeya
丽莎=Lisa
主角（旅行者）=Traveler
芭芭拉=Barbara
北斗=Beidou
班尼特=Bennett
重云=Chongyun
迪卢克=Diluc
菲谢尔=Fischl
琴=Jean
刻晴=Keqing
可莉=Klee
莫娜=Mona
凝光=Ningguang
诺伊尔=Noelle
七七=Qiqi
雷泽=Razor
砂糖=Sucrose
温迪=Venti
香菱=Xiangling
魈=Xiao
行秋=Xingqiu

无相之雷=Electro Hypostasis
无相之风=Anemo Hypostasis
无相之岩=Geo Hypostasis
纯水精灵=Oceanid
急冻树=Cryo Regisvine
爆炎树=Pyro Regisvine
